abstraksi=abstrak
acau=kacau
acbuyer=pembeli akun
acc=akun
acount=akun
acounts=akun
actleast=setidaknya
admin=administrator
afk=meninggalkan
afking=meninggalkan
ahir=akhir
alt=alternatif
asf=asap
ataw=atau
ato=atau
awal=mula
back=mundur
backdoor=menyerang tanpa creep
bait=umpan
bandingkan=banding
banyak=beberapa
batle=pertempuran
bdg=banding
bdsm=perbudakan dominasi sadisme masokisme
begin=mulai
begitu=seperti itu
besok=esok
bgt=banget
bising=berisik
bkb=black king bar
bla=bla bla bla
blm=belum
bm=blade mail
bnyk=banyak
boi=boy
boosters=joki
bost=boost
bro=brother
brp=berapa
bs=bisa
buat=untuk
buruk=jelek
bye=goodbye
byk=banyak
calm=tenang
cantik=indah
carry=core
cd=cooldown
cepet=cepat
chars=karakter
coldown=cooldown
comand=command
comeback=balik menang
comend=commend
comends=commends
comm=komunikasi
commend=pujian
comms=komunikasi
comp=competition
compedium=compendium
competiton=competition
cooldowns=cooldown
cpt=cepat
crowded=ramai
cry=ngeluh
cs=last hit
cyka=maki rusia
d=di
dc=disconnect
dced=disconnected
dd=double damage
debuf=debuff
def=bertahan
detsh=death
dev=developer
devs=developers
dg=dengan
dgn=dengan
dic=disk
dif=difference
dificult=difficult
dificulty=difficulty
dig=menggali
dii=di
dikit=sedikit
dimafkan=dimaklumi
dimainkanya=dimainkannya
dimbang=diimbang
dinstal=install
dinvestasikan=investasi
dipangil=panggil
disconect=disconnect
ditawarkanya=ditawarkannya
ditingalkan=tinggal
dityabot=dianggap bot
dityaingi=dianggap ini
dll=dan lain lain
dmg=damage
draft=draf pilih
dsb=dan sebagainya
dst=dan seterusnya
edit=mengedit
elo=ELO rating
esok=besok
e-sport=esport
exp=experience
ez=mudah
farm=farming
fck=fuck
ff=menyerah
fkng=fucking
fortres=fortress
fountain=markas
fundamen=fundamental
ga=tidak
gabena=gaben
gak=tidak
gameplay=gaya main
gampang=mudah
ganking=proses gank
gausah=tidak usah
gg=permainan bagus
ggwp=permainan bagus
gini=begini
gitu=begitu
glhf=semoga menyenangkan
gmn=bagaimana
grat=gratis
gtu=begitu
hack=retas
harus=wajib
hf=senang
hit=serang
hypercary=hypercarry
imbalanya=imbalannya
itemization=pemilihan item
jangan=tidak
jelek=buruk
jgn=jangan
jng=jangan
jungle=hutan
kayak=seperti
kebijaksanan=kebijaksanaan
kek=seperti
kekcewan=kekecewaan
kemampuanya=kemampuannya
kemanusian=kemanusiaan
kemungkinanya=kemungkinannya
keren=bagus
keseimbanganya=keseimbangannya
kesimpulanya=kesimpulannya
kmrn=kemarin
kompleks=rumit
kordinator=koordinator
krg=kurang
krng=kurang
ks=kill steal
kumunitas=komunitas
kurang=tidak cukup
kyk=seperti
l2p=belajar main
lag=lag
lama=panjang
lambat=perlahan
langanan=langganan
lanjut=berikutnya
lbh=lebih
lg=lagi
lgi=lagi
lipatanya=lipatannya
lma=lama
lop=loop
lp=low priority
make=menggunakan
mancur=hancur
mantap=bagus
matchmaking=pencocokan
medium=sedang
mem=memory
memasukanya=memasukkannya
membiarkanya=membiarkannya
menangung=menanggung
meningalkanya=meninggalkannya
messed up algorithm=algoritma buruk
mesti=harus
mia=miss
mid=jalur tengah
min=minute
mmr=match making ranking
moga=semoga
money=uang
months=bulan
morfling=morphling
moron=kata kasar
morons=kata kasar
motherfker=motherfucker
mudah=gampang
mulai=memulai
n=tidak
nanti=kemudian
naty=natty
nauture=nature
necesary=necessary
ned=need
nerd=istilah
nerds=istilah
nerfes=nerfs
newbie=pemula
newkomer=newcomer
next=berikutnya
ngen=engine
nggak=tidak
ngiler=ekspresi
no=tidak
nobie=newbie
noise=suara
noisy=berisik
non-smurfing=akun utama
nope=tidak
normals=normal
ntar=nanti
nthe=the
nti=nanti
numerior=numerical
obrolanya=obrolannya
ocasi=occasion
ofc=of course
offlane=jalur samping
oflaner=offlaner
ofside=offside
ok=baik
oke=baik
olok=olok olok
oom=kehabisan mana
optimalisasi=optimisasi
optimasi=optimisasi
org=orang
org2=orang orang
overal=overall
overcom=overcome
pakai=menggunakan
pake=menggunakan
paling=paling
pambansang=pambangsang
paning=panik
parakm=param
partuculary=particularly
pause=jeda
pedo=pedofil
pemulian=pemulihan
pence=penting
pendek=singkat
pengangu=pengganggu
penganiayan=penganiayaan
pengerjan=pengerjaan
pengetahuanya=pengetahuannya
penginjaman=peminjaman
pengunan=penggunaan
pengunanya=penggunanya
penilaianya=penilaiannya
penungang=penunggang
perjodohanya=perjodohannya
perma=permanent
pernyatan=pernyataan
pertanyan=pertanyaan
peruvians=peru player
phd=Doctor of Philosophy
ping=ping
pinoy=pinoy
plae=play
plat=platinum
plg=paling
pma=positif
poast=post
poj=pojok
pos5=posisi
posible=possible
potonganya=potongannya
pra=pra
pre=pre
pres=president
primeal=primeval
prio=priority
programer=programmer
psikos=psikosis
pull=tarik
push=dorong
pusies=pusat
que=antrian
qued=queued
quewed=queued
quiet=sepi
rabit=rabbit
rankes=ranking
realy=really
redit=reddit
rekomend=rekomendasi
relax=santai
reneksi=refleksi
repot=sibuk
rly=really
rng=untung
rol=role
roler=roller
rolers=rollers
ros=roshan
rpgs=Role Playing Games
rts=Real Time Strategy
rumit=kompleks
russians=rusia player
scamed=scammed
scrols=scrolls
sdg=sedang
sdh=sudah
sdikit=sedikit
sdkt=sedikit
secord=second
semingu=seminggu
sepi=sunyi
shadowban=blokir bayang
siksan=siksaan
simes=times
singkat=pendek
siting=sitting
skil=skill
skilshot=skillshot
skilshots=skillshots
skrg=sekarang
skrng=sekarang
slep=sleep
sm=sama
sma=sama
smack=ejekan
smd=kotor
smoke=asap
smurf=smurf
smurfing=smurf
solo=solo
spec=specification
sped=speed
splitpush=split push
spreadshet=spreadsheet
spt=seperti
ss=missing signal
stack=stack
stacks=stack
statmaking=stat making
steamroll=gulung mudah
sticned=sticked
stresful=stressful
stu=stew
stuipid=stupid
sulit=rumit
sunguh=sungguh
susah=sulit
sweatland=pro player
t=tidak
tadi=sebelumnya
tangap=tanggap
tangkapanya=tangkapannya
tanguh=tangguh
tantanganya=tantangannya
tapi=tetapi
td=tadi
tdk=tidak
teamfight=pertempuran tim
terible=terrible
terorist=teroris
terus=kemudian
tf2=team fortress
throne=ancient
timernya=timernya
tingalkan=tinggalkan
tleast=at least
tolo=tolol
tp=teleport
tpi=tapi
tpscroll=teleport scroll
trakhir=terakhir
truelnya=sebenarnya
trus=terus
try=coba
tryhard=berusaha keras
tujuanya=tujuannya
tunelvision=tunnel vision
tungu=tunggu
turb=turbo
tuscle=muscle
udah=sudah
udh=sudah
ul=ultimate
ulasanya=ulasannya
ults=ultimates
unbelivabel=unbelievable
unhapy=unhappy
uninstal=uninstall
unrank=unranked
untuku=untukku
usah=tidak perlu
usd=US Dollar
useles=useless
usles=useless
utk=untuk
utuk=untuk
valva=valve
vave=valve
videogame=video game
vidoes=videos
vingar=vinegar
voice=suara
vopice=voice
wan=wanita
wanabe=wannabe
warhamer=warhammer
wd=witch doctor
wil=will
wilow=willow
winer=winner
wole=whole
woth=worth
wp=bagus
xp=exp
y=ya
yes=ya
yg=yang
yolo=kamu hanya hidup sekali