agam=agama
alami=alam
ancients=ancient
antarmuka=muka
asai=asa
bijaksana=bijak
booster=boost
diberitahu=beri tahu
diinstal=instal
dinamika=dinamis
dramatis=drama
eksistensial=eksistensi
eksperimen=coba
eksploitasi=eksploit
elitisme=elit
emosional=emosi
erti=arti
evolved=evolusi
fiturnya=fitur
free=gratis
frustasi=frustrasi
fundamental=fundamen
gameplaynya=gameplay
gamer=game
games=game
gaming=game
ganks=gank
good=bagus
instalan=instal
instalasi=instal
kekanak=anak
keputusasaan=putus asa
ketidakseimbangan=tidak imbang
komitmen=komit
kompetitif=kompetisi
kompleksitas=kompleks
konsekuensi=akibat
kreativitas=kreatif
kustomisasi=kustom
legendaris=legenda
legends=legenda
legion=legiun
like=suka
love=cinta
manajemen=manage
mekanika=mekanik
mekanis=mekanik
mekanisme=mekanik
menghisap=hisap
menginstal=instal
menginstalnya=instal
noobs=noob
nyiakan=sia
optimisasi=optimal
orientasi=orient
pamungkas=pungkas
pelihara=piara
pemberitahuan=beri tahu
penyalahgunaan=salah guna
people=orang
perangkap=rangkap
perangkat=alat
perhati=hati
perilaku=laku
peringkat=pangkat
peristiwa=jadi
perlahan=lahan
permanen=tetap
persetan=setan
players=player
playing=main
popularitas=populer
potensial=potensi
ranked=rank
ranks=rank
rekomendasi=rekomend
responsif=respons
sepenuh=penuh
seringkali=sering kali
sinkronisasi=sinkron
smurfing=smurf
smurfs=smurf
strategis=strategi
sukacita=suka cita
sukarela=suka rela
